27
************************************************************************************
************************************************************************************
************************************************************************************
************************************************************************************
************************************************************************************
************************************************************************************
************************************************************************************
************************************************************************************
************************@@@@@@@@@@@@@@@@@@@@@@@@@@@@@@@@@@@@@@**********************
************************@************************************@**********************
************************@************************************@**********************
************************@************************************@**********************
************************@************************************@**********************
************************@************************************@**********************
************************@************************************@**********************
************************@************************************@**********************
*******************@@@@@@************************************@**********************
*******************@*****************************************@**********************
*******************@*****************************************@**********************
*******************@*****************************************@**********************
*******************@*****************************************@**********************
*************************************************************@@@@@@@@@@*************
**********************************************************************@*************
**********************************************************************@*************
*******************@**************************************************@*************
*******************@@@@@@@@@@@@@@@@@@@@@@@@@@@@@@@@@@@@@@@@@@@@@@@@@@@@*************
************************************************************************************